*******************************************--*********************************************
*                                                                                        *
*                                                                                        *
*                                                                                        *
*                                                                                        *
*                                                                                        *
*                                                                                        *
*                                                                                        *
*                                                                                        *
*                                                                                        *
*                                                                                        *
*                                                                                        *
|                                                                                        |
*                                                                                        *
*                                                                                        *
*                                                                                        *
*                                                                                        *
*                                                                                        *
*                                                                                        *
*                                                                                        *
*                                                                                        *
*                                                                                        *
*                                                                                        *
*                                                                                        *
*******************************************--*********************************************

